#########################################################################
#----------#---------#-##------------#---#->----#--------#--------------#
#-@--------#---------+-##------------#-#-#------#---*----#--------------#
#----------#---------#-##------------#-#-#--*---#--------#--------*-----#
########---#---------#-##------------#-#-#------#--------#--------------#
#----------#--*------#-----#---------#-#-######-#--------+---*----*-----#
#----------#---------#-----#---------#-#--------#--------#--------------#
#--*-------#---------#-----#---------#+########-#--------#--------------#
#----------#---------#-----#------------------#-#--------#########------#
#----------#---------#-----#------------------#-##---------------#------#
#----------#---------#-----#------------------#--#----#####--*---#--*---#
#----------#---------#-----#------------------#--#---------------#------#
#----------######----#-------*----------------#--#---------------#--O---#
#---------------+----#---##################---#--#---------------########
#######----######----#------------------------#--#---#######------------#
#->---#----#---------###############----------#--#---------#----#-------#
#-----#----#---------#------------------------#--#----*----#----#---*---#
#----------#----*----#--------*---------------#--#---------#----#-------#
#----*-----#->-------#-------------#----------#--#-----#--------#--->---#
#----------#---------#-------------#-------->-#--------#--------#-------#
#########################################################################