####################################################
#--------------------------------------------------#
#-@------------------------------------------------#
#--------------------------------------------------#
#--------------------------------------------------#
#--------------------------------------------------#
#--------------------------------------------------#
#--------------------------------------------------#
#--------------------------------------------------#
#----------------######+#####----------------------#
#----------------#----------#----------------------#
#----------------#----------#----------------------#
#----------------#----------#----------------------#
#----------------#----------#----------------------#
#----------------#----------#----------------->----#
#----------------#-----O----#----------------------#
####################################################
