#################################################
#----------------------------------#----#---O---#
#-@--------------------------------#----#-------#
#---------------------###----------#----#-------#
#---------------------###----------#----+-------#
#---------------------###----------#----#########
#---------------------###----------#------------#
#---------------------###----------#------------#
#---------------------###----------#------------#
#---------------------###--*-------#------------#
#---------------------###-----------------------#
#---------------------###-----------------------#
#######---------------###-----------------------#
#-----###################------##################
#-->--------------------------------------------#
#-----------------------------------------------#
#################################################